11111111111111111111
10000000000000000001
1000000E000000000C01
10000000000000000001
1000000000000000P001
11111111111111111111